"","Var1","Freq"
"1","N0",90
"2","N1",37
"3","N1a",3
"4","N1b",5
"5","N1c",1
"6","N2",25
"7","N2a",3
"8","N2b",8
"9","NX",2
